416 ECONOMY OF EXPRESSION

later used for anything that is of the right standard), "C.O.D." (cash on delivery by post), "C.P." (Communist Party), "B.A.T." (British American Tobacco Co.), etc.

16.42. Monosyllabism.—The same desire for brevity is seen in another tendency to substitute short words for long ones, especially in current American slang. Below are some examples (the specifically American or English slang words are indicated):—

cop = copper = policeman
thug = gangster
buck = dollar, as in “three bucks” (Am.)
guy = fellow (Am.)
chap = fellow (Eng.)
kid = child
grub = food, feed (Eng.)
bite, snack = a light lunch
grit = endurance
guts = real value, inner force
swop = change
fake = forgery, anything false
fad, craze = fashion
crib = plagiarize
cram = work hard before examination
grab = take by force
lot = amount
hike = make an excursion on foot
probe = investigation
boss, chief = manager or president
date = appointment with girls
lift = elevator

sack—“give, get the sack” = dismiss, be dismissed
pop = papa
mom = mamma
kick = protest (“raise a kick”)
row = quarrel (“raise, make a row”)
push = aggressive or enterprising spirit
fit = in good health (Eng.)
deal = business transaction
job, post = position.
dough = money (Am.)
tip = suggestion (“give you a tip”)
clue = suggestive evidence
off = finished, over
through—“am through with you” = will have no more to do with you
up = has come up (“What is up?” “subject is up for discussion”)
play = drama
broke = bankrupt
bum = penniless loafer

A very long list could be drawn up of these monosyllabic words, but the above, some of which are in literary use,